Lighting Day
Music Play
BackgroundType None
Player 8 1 46 70 5 -20 20 0.75
Tile Plat 0 0 1 1 0 0
Tile Plat 1 0 1 1 0 0
Tile Plat 2 0 1 1 0 0
Tile Plat 3 0 1 1 0 0
Tile Plat 4 0 1 1 0 0
Tile Plat 5 0 1 1 0 0
Tile Plat 6 0 1 1 0 0
Tile Plat 7 0 1 1 0 0
Tile Plat 8 0 1 1 0 0
Tile Plat 9 0 1 1 0 0
Tile Plat 10 0 1 1 0 0
Tile Plat 11 0 1 1 0 0
Tile Plat 12 0 1 1 0 0
Tile Plat 13 0 1 1 0 0
Tile Plat 14 0 1 1 0 0
Tile Plat 15 0 1 1 0 0
Tile Plat 17 0 1 1 0 0
Tile Plat 16 0 1 1 0 0
Tile Plat 18 0 1 1 0 0
Tile Plat 19 0 1 1 0 0
Tile Plat 20 0 1 1 0 0
Tile Plat 21 0 1 1 0 0
Tile Plat 22 0 1 1 0 0
Tile Plat 23 0 1 1 0 0
Tile Plat 24 0 1 1 0 0
Tile Plat 25 0 1 1 0 0
Tile Plat 26 0 1 1 0 0
Tile Plat 27 0 1 1 0 0
Tile Plat 28 0 1 1 0 0
Tile Plat 29 0 1 1 0 0
Tile Plat 30 0 1 1 0 0
Tile Plat 31 0 1 1 0 0
Tile Plat 32 0 1 1 0 0
Tile Plat 33 0 1 1 0 0
Tile Plat 34 0 1 1 0 0
Tile Plat 35 0 1 1 0 0
Tile Plat 36 0 1 1 0 0
Tile Plat 37 0 1 1 0 0
Tile Plat 38 0 1 1 0 0
Tile Plat 39 0 1 1 0 0
Tile Plat 40 0 1 1 0 0
Tile Plat 41 0 1 1 0 0
Tile Plat 42 0 1 1 0 0
Tile Plat 43 0 1 1 0 0
Tile Plat 44 0 1 1 0 0
Tile Plat 45 0 1 1 0 0
Tile SpikeUp 11 1 1 1 0 0
Tile SpikeUp 16 1 1 1 0 0

Npc WormIdle 12 1 1 1 0 0

Tile SpikeUp 22 1 1 1 0 0
Npc DemonIdle 17 1 1 1 0 0

Npc WormIdle 63 14 1 3 1 0 0.75 3 Patrol 2 63 14 66 14
Npc WormIdle 55 24 1 3 1 0 0.75 2 Follow
Npc WormIdle 85 10 -1 3 1 0 0.75 2 Patrol 2 85 10 79 10
Npc WormIdle 106 1 -1 3 1 0 0.75 2 Follow
Npc DemonIdle 53 18 -1 5 3 0 0.75 2 Patrol 2 53 18 63.01 18





Tile BlueBolt 0 1 1 1 0 0
Tile BlueShield 1 1 1 1 0 0
Tile BlueStar 2 1 1 1 0 0
Tile PillBlue 3 1 1 1 0 0
Tile PillGreen 4 1 1 1 0 0
Tile PillRed 5 1 1 1 0 0
Tile Plat 0 7 1 1 0 0
Tile Plat 1 7 1 1 0 0
Tile Plat 2 7 1 1 0 0
Tile Plat 3 7 1 1 0 0
Tile Plat 4 7 1 1 0 0
Tile Plat 5 7 1 1 0 0
Tile Plat 6 7 1 1 0 0
Tile Plat 7 7 1 1 0 0
Tile Plat 9 7 1 1 0 0
Tile Plat 8 7 1 1 0 0
Tile Plat 10 7 1 1 0 0
Tile Plat 11 7 1 1 0 0
Tile Plat 12 7 1 1 0 0
Tile Plat 13 7 1 1 0 0
Tile Plat 14 7 1 1 0 0
Tile Plat 15 7 1 1 0 0
Tile Plat 16 7 1 1 0 0
Tile Plat 17 7 1 1 0 0
Tile Plat 18 7 1 1 0 0
Tile Plat 19 7 1 1 0 0
Tile Plat 20 7 1 1 0 0
Tile Plat 21 7 1 1 0 0
Tile Plat 22 7 1 1 0 0
Tile Plat 23 7 1 1 0 0
Tile Plat 24 7 1 1 0 0
Tile Plat 25 7 1 1 0 0
Tile Plat 26 7 1 1 0 0
Tile Plat 27 7 1 1 0 0
Tile Plat 28 7 1 1 0 0
Tile Plat 29 7 1 1 0 0
Tile Plat 30 7 1 1 0 0
Tile Plat 31 7 1 1 0 0
Tile Plat 32 7 1 1 0 0
Tile Plat 33 7 1 1 0 0
Tile Plat 34 7 1 1 0 0
Tile Plat 35 7 1 1 0 0
Tile Plat 36 7 1 1 0 0
Tile Plat 37 7 1 1 0 0
Tile Plat 38 7 1 1 0 0
Tile Plat 39 7 1 1 0 0
Tile Plat 40 7 1 1 0 0
Tile Plat 41 7 1 1 0 0
Tile Plat 42 7 1 1 0 0
Tile Plat 43 7 1 1 0 0
Tile Plat 44 7 1 1 0 0
Tile Plat 45 7 1 1 0 0
